1111111011
1000001001
1010000101
1010110001
1010101011
1011101001
1000021001
1001111001
1111001001
1111111111