1111111111
1000001001
1010000101
1010100001
1010101011
1011101001
1000021001
1001011001
1111001001
1111111011