1111111011
1000000001
1010000001
1010111001
1010101001
1011101001
1000021001
1001111001
1000001001
1111111111